20
20
1 1 1 1 1 1 1 1 1 1 1 1 1 1 1 1 1 1 1 1 
1 1 1 1 1 1 1 1 1 1 82 83 1 1 1 1 1 1 1 1 
1 1 1 1 1 1 1 1 1 1 78 79 1 1 1 1 1 1 1 1 
1 1 1 1 1 1 1 1 1 1 1 1 1 1 1 1 82 83 1 1 
1 1 1 1 1 1 1 1 1 1 1 1 1 1 1 1 78 79 1 1 
1 1 1 16 72 11 72 17 72 11 18 1 1 1 1 1 1 1 1 1 
1 1 1 12 68 7 68 13 68 7 14 1 1 1 1 1 1 1 1 1 
1 1 1 8 9 9 9 9 9 9 10 1 1 1 1 1 82 83 1 1 
1 1 1 4 5 5 5 5 5 5 6 1 1 1 1 1 78 79 1 1 
1 1 1 1 1 1 1 1 1 1 1 1 1 1 1 1 1 1 1 1 
1 1 1 1 1 1 1 1 1 1 1 1 1 1 1 1 1 1 1 1 
1 1 1 1 1 1 1 1 1 1 1 1 1 1 1 1 82 83 1 1 
1 82 83 1 1 1 1 1 1 1 82 83 1 1 1 1 78 79 1 1 
1 78 79 1 1 1 1 1 1 1 78 79 1 1 1 1 1 1 1 1 
1 1 1 1 1 1 1 1 1 1 1 1 1 1 1 1 1 1 1 1 
1 1 1 1 1 1 48 49 50 51 1 1 1 1 82 83 1 1 1 1 
1 1 1 1 1 1 44 45 46 47 1 1 1 1 78 79 1 1 1 1 
1 1 1 1 1 1 40 41 42 43 1 1 1 1 1 1 1 1 82 83 
1 1 1 1 1 1 36 37 38 39 1 1 1 1 1 1 1 1 78 79 
1 1 1 1 1 1 1 1 1 1 1 1 1 1 1 1 1 1 1 1 
