10
10
48 49 50 51 1 1 48 49 50 51 
44 45 46 47 1 1 44 45 46 47 
40 41 42 43 1 1 40 41 42 43 
36 37 38 39 1 1 36 37 38 39 
1 1 1 1 1 1 1 1 1 1 
1 1 1 1 1 1 1 1 1 1 
48 49 50 51 1 1 48 49 50 51 
44 45 46 47 1 1 44 45 46 47 
40 41 42 43 1 1 40 41 42 43 
36 37 38 39 1 1 36 37 38 39 
