20
20
1 1 1 1 1 1 1 1 1 1 1 1 1 1 1 1 1 1 1 1 
1 1 1 1 1 1 1 1 1 1 1 1 1 1 1 1 1 1 1 1 
1 1 1 1 1 1 1 1 1 1 1 27 28 1 1 1 1 1 1 1 
1 1 1 1 1 1 1 1 1 1 1 11 12 1 1 1 1 1 1 1 
1 1 1 1 1 1 1 1 1 1 1 1 1 1 1 1 1 1 1 1 
1 1 1 27 28 1 1 1 1 1 1 1 1 1 1 1 1 1 1 1 
1 1 1 11 12 1 1 1 1 1 1 1 1 1 1 1 1 1 1 1 
1 1 1 1 1 1 1 1 29 15 15 30 1 1 1 1 27 28 1 1 
1 1 1 1 1 1 1 1 20 20 19 20 1 1 1 1 11 12 1 1 
1 1 1 1 1 1 1 1 32 33 33 32 1 1 1 1 1 1 1 1 
1 1 1 1 1 1 1 1 16 17 17 18 1 1 1 1 1 1 1 1 
1 1 1 1 1 1 1 1 1 1 1 1 1 1 1 1 1 1 1 1 
1 1 1 1 1 1 1 1 1 1 1 1 1 1 1 1 1 1 1 1 
1 1 1 1 1 1 1 1 1 1 1 1 1 1 1 1 1 1 1 1 
1 1 1 1 1 1 1 1 1 1 1 1 1 27 28 1 1 1 1 1 
1 1 1 21 21 21 1 1 1 1 1 1 1 11 12 1 1 1 1 1 
1 1 1 21 21 21 1 1 1 1 1 1 1 1 1 1 1 1 1 1 
1 1 1 21 21 21 1 1 1 1 1 1 1 1 1 1 1 1 1 1 
1 1 1 1 1 1 1 1 1 1 1 1 1 1 1 1 1 1 1 1 
1 1 1 1 1 1 1 1 1 1 1 1 1 1 1 1 1 1 1 1 
