20
20
1 1 1 1 1 1 1 1 1 1 1 1 1 1 1 1 16 17 18 1 
1 1 16 17 18 1 1 1 1 1 1 1 1 1 1 1 12 13 14 1 
1 1 12 13 14 1 1 1 1 1 16 17 18 1 1 1 8 9 10 1 
1 1 8 9 10 1 1 1 1 1 12 13 14 1 1 1 8 9 10 1 
1 1 8 9 10 1 1 1 1 1 8 9 10 1 1 1 4 5 6 1 
1 1 4 5 6 1 1 1 1 1 8 9 10 1 1 1 1 1 1 1 
1 1 1 1 1 1 1 1 1 1 4 5 6 1 1 1 1 1 1 1 
1 1 1 1 1 16 17 18 1 1 1 1 1 16 17 18 1 1 1 1 
1 16 17 18 1 12 13 14 1 1 1 1 1 12 13 14 1 1 1 1 
1 12 13 14 1 8 9 10 1 1 1 1 1 8 9 10 1 1 1 1 
1 8 9 10 1 8 9 10 1 1 16 17 18 8 9 10 16 17 18 1 
1 8 9 10 1 4 5 6 1 1 12 13 14 4 5 6 12 13 14 1 
1 4 5 6 1 1 1 1 1 1 8 9 10 1 1 1 8 9 10 1 
1 1 1 1 16 17 18 1 1 1 8 9 10 1 1 1 8 9 10 1 
1 1 1 1 12 13 14 1 1 1 4 5 6 1 1 1 4 5 6 1 
1 1 1 1 8 9 10 1 1 1 1 1 1 1 1 1 1 1 1 1 
1 1 1 1 8 9 10 1 1 1 1 1 1 1 1 1 1 1 1 1 
16 17 18 1 4 5 6 1 1 1 16 17 18 1 1 1 16 17 18 1 
12 13 14 1 1 1 1 1 1 1 12 13 14 1 1 1 12 13 14 1 
8 9 10 1 1 1 1 1 1 1 8 9 10 1 1 1 8 9 10 1 
