20
20
21 21  1  1  1  1  1  1  1 21 21 21 21 21  1  1  0  0  0  0
21  1  1  1  1  1  1  1 21 21 21 21 21  1  1  1  0  0  0  0
 1  1  1  0  0  0 21 21 21 21 21 21  1  1  1  1  1  0  0  0
 1  1  0  0  0  0  0 21 21 21 21  1  1  1  1  1  1  1  1  0
 1  1  0  0  0  0  0 21 21 21  1  1  1  1  1  1  1  1  1  1
 1  1  0  0  0  0  0 21 21 21  1  1  1  1  1  1  1  1  1  1
 1  1  0  0  0  0  0 21 21 21  1  1  1  1  1  1  1  1  1  1
 1  1  0  0  0  0  0 21 21 21  1  1  1  1  1  1  1  1  1  1
 1  1  1  0  0  0 21 21 21  1  1  1  1  1  1  1  1  1  1  1
 1  1  1  1  1  1  1  1  1  1  1  1  1  1  1  1  1  1  1 21
 1  1  1  1  1  1  1  1  1  1  1  1  1  1  1  1  1  1 21 21
 1  1  1  1  1  1  1  1  1  1  1  1  1  1  1  1  1  1 21 21
 1  1  1  1  1  1  1  1  1  1  1  1  1  1  1  1  1  1  1 21
 1  1  1  1  1  1  1  1  1  1  1  1  1  1  1  1  1  1  1  1
 1  3  1  1  1  1  1  1  1  1  1  1  1  1  1  1  1  1  1  1
 1 27 28  1  1  1  1  1  1  1  1  1  1  1  1  1  3  4  4  4
 1 11 12  1  1  1  1  1  1  1  1  1  1  1  1  1 29 15 15 30
21  1  1  1  1  1  1  1  1  1  1  1  1  1  1  1 13  1  1 14
21 21  1  1  1  1  1  1  1  1  1  1  1  1  1  1 13 27 28 14
21 21 21  1  1  1  1  1  1  1  1  1  1  1  1  1 13 11 12 14
