20
20
1 1 1 1 1 1 1 1 1 1 1 1 1 1 1 1 1 1 1 1 
1 1 1 1 1 1 1 1 1 1 1 1 1 1 1 1 1 1 1 1 
1 1 1 1 1 1 1 1 1 1 1 1 1 1 1 1 1 1 1 1 
1 1 1 1 1 1 1 1 1 1 1 1 1 1 1 1 1 1 1 1 
1 1 1 1 1 1 60 61 61 61 61 61 61 61 62 1 1 1 1 1 
1 1 1 1 1 1 56 57 57 57 57 57 57 57 58 1 1 1 1 1 
1 1 1 1 1 1 56 57 57 57 57 57 57 57 58 1 1 1 1 1 
1 1 1 1 1 1 56 57 57 57 57 57 57 57 58 1 1 1 1 1 
1 1 1 1 1 1 56 57 57 57 57 57 57 57 58 1 1 1 1 1 
1 1 1 1 1 1 56 57 57 57 57 57 57 57 58 1 1 1 1 1 
1 1 1 1 1 1 52 53 53 53 53 53 53 53 54 1 1 1 1 1 
1 1 1 1 1 1 1 1 1 1 1 1 1 1 1 1 1 1 1 1 
1 1 1 1 1 1 1 1 1 1 1 1 1 1 1 1 1 1 1 1 
1 1 1 1 1 1 1 1 1 1 1 1 1 1 1 1 1 1 1 1 
1 1 1 1 1 1 1 1 1 1 1 1 1 1 1 1 1 1 1 1 
1 1 1 1 1 1 1 1 1 1 1 1 1 1 1 1 1 1 1 1 
1 1 1 1 1 1 1 1 1 1 1 1 1 1 1 1 1 1 1 1 
1 1 1 1 1 1 1 1 1 1 1 1 1 1 1 1 1 1 1 1 
1 1 1 1 1 1 1 1 1 1 1 1 1 1 1 1 1 1 1 1 
1 1 1 1 1 1 1 1 1 1 1 1 1 1 1 1 1 1 1 1 
