20
20
0 0 0 0 0 0 0 0 0 0 0 0 0 0 0 0 0 0 0 0 
0 0 0 0 0 0 0 0 0 0 0 0 0 0 0 0 0 0 0 0 
0 0 0 0 0 0 0 0 0 0 0 0 0 0 0 0 0 0 0 0 
0 0 0 0 0 0 0 0 0 0 0 0 0 0 0 0 0 0 0 0 
0 0 0 0 0 0 0 0 0 0 48 49 50 51 0 0 0 0 0 0 
0 0 0 0 0 0 0 0 0 0 44 45 46 47 0 0 0 0 0 0 
0 0 0 0 0 0 0 0 0 0 40 41 42 43 0 0 0 0 0 0 
0 0 0 48 49 50 51 0 0 0 36 37 38 39 0 0 0 0 0 0 
0 0 0 44 45 46 47 0 0 0 0 0 0 0 0 0 0 0 0 0 
0 0 0 40 41 42 43 0 0 0 0 0 0 0 0 0 0 0 0 0 
0 0 0 36 37 38 39 0 0 0 0 0 0 0 0 0 0 0 0 0 
0 0 0 0 0 0 0 0 0 0 0 0 0 0 0 0 0 0 0 0 
0 0 0 0 0 48 49 50 51 0 0 0 0 0 0 0 0 0 0 0 
0 0 0 0 0 44 45 46 47 0 0 0 0 0 0 0 0 0 0 0 
0 0 0 0 0 40 41 42 43 0 0 0 0 0 0 0 0 0 0 0 
0 0 0 0 0 36 37 38 39 0 0 0 0 0 0 0 0 0 0 0 
0 0 0 0 0 0 0 0 0 0 0 0 0 0 0 0 0 0 0 0 
0 0 0 0 0 0 0 0 0 0 0 0 0 0 0 0 0 0 0 0 
0 0 0 0 0 0 0 0 0 0 0 0 0 0 0 0 0 0 0 0 
0 0 0 0 0 0 0 0 0 0 0 0 0 0 0 0 0 0 0 0 
